35
                               *****************                               
                              ************************                         
                              ***************************                      
                              ******************************                   
                ***           *********************************                
              ******        ******************************************         
            *****************************                                      
           ***************************                                         
          **********         **********                                        
         ***********          ********                                         
        ************          ********         ************************        
       *************          *******         **************************       
      **************          *******         **************************       
      **************          *******         ***************************      
      **************          *******          *                 ********      
     ***************          *******                               *****      
     ***************          ******                                  ***      
     ***************         ********              *****               **      
     ***************          ******            ***********             *      
      **************         ********         ***************                  
      **************          ********************************                 
      **************          ********************************                 
       *************          ******************************                 
        ***********           ******          ****************                 
        **********            ******          ***************                  
         ********            ********            ********                    
                             ********                                          
                            **********                                         
                         ***************                                       
                       *******************                                     
                  ********************************      ****                   
                     ************************************                      
                        ******************************                         
                              *******************                              
                                  ***********                                  
                                    *******                                    
