30
                         ******
                  ********************                   
              ****************************               
           **********************************            
         **************************************          
       ******************************************        
     **********************************************      
    ************************************************     
   ************                             *********    
  ***********                               **********   
  ********** ********    *******     ******************  
 ********************   *******     *******************  
 ********************  ********    ********************
 ******************   *********    *********************
 *****************    *******     ********************** 
 ****************     ******      ********************** 
 **************      *******     ***********************
 ************       *******      **********************  
  **********       ********      *********************   
  ********        *********           ****************   
   ********      ***********        *****************    
    ************************************************     
      *********************************************      
       ******************************************        
         **************************************          
           **********************************            
               ***************************               
                  ********************
                        *********
                         *******